A$AP Rocky - "HIGHJACK"
Adrianne Lenker - "Sadness as a Gift"
Alice Longyu Gao - "‚ô° Korean Girls"
Aliyah‚Äôs Interlude - "Fashion Icon"
Amyl and the Sniffers - "U Should Not Be Doing That"
Ari Lennox - "Smoke"
Armand Hammer - "Doves"
bbno$ - "it boy"
Beth Gibbons - "Floating on a Moment"
Chappell Roan - "Good Luck, Babe!"
Charley Crockett - "$10 Cowboy"
Charli XCX & Lorde - "The girl, so confusing version with Lorde"
Chat Pile - "I Am Dog Now"
Chelsea Wolfe - "Everything Turns Blue"
clipping. - "Run It"
Denzel Curry - "HOT ONE"
Doechii - "Alter Ego"
Dog Race - "It‚Äôs the Squeeze"
Elias R√∏nnenfelt - "No One Else"
Fat Dog - "Wither"
FKA twigs - "Perfect Stranger"
FLO - "Caught Up"
Fontaines D.C. - "Starburster"
Geordie Greep - "Holy, Holy"
Ginger Root - "No Problems"
Hiatus Kaiyote - "Cinnamon Temple"
horsegiirL - "eat, sleep, slay, üîÅ"
Ibibio Sound Machine - "Pull the Rope"
Jamie xx - "Baddy on the Floor"
Jane Remover - "Magic I Want U"
Joey Valence & Brae - "THE BADDEST"
Justice - "Generator"
Kamasi Washington - "Prologue"
Kendrick Lamar - "meet the grahams"
Kim Gordon - "BYE BYE"
Knocked Loose - "Suffocate"
Laura Marling - "No One‚Äôs Gonna Love You Like I Can"
The Lemon Twigs - "My Golden Years"
Magdalena Bay - "Death & Romance"
Moses Sumney - "Vintage"
Nia Archives - "Crowded Roomz"
Porter Robinson - "Cheerleader"
Remi Wolf - "Toro"
Sampha & Little Sims - "Satellite Business 2.0"
Shygirl - "encore"
test plan - "Walking in a Vacuum"
Tierra Whack - "27 CLUB"
Tinashe - "Nasty"
Vampire Weekend - "Classical"
Xiu Xiu - "Veneficium"
